Buona	ADJqua	bon
pulcella	NOMcom	pucelle
fut	VERcjg	être
Eulalia	NOMpro	Eulalie
.	PONfrt	.

Bel	ADJqua	beau
auret	VERcjg	avoir
corps	NOMcom	corps
bellezour	ADJqua	belleur
anima	VERcjg	animer
.	PONfrt	.

Voldrent	VERcjg	vouloir
la	PROper	il
veintre	VERinf	vaincre
li	DETdef	le
Deo	NOMpro	Dieu
inimi	NOMcom	innim
.	PONfrt	.

Voldrent	VERcjg	vouloir
la	PROper	il
faire	VERinf	faire
diaule	NOMcom	diaule
servir	VERinf	servir
.	PONfrt	.

Elle	PROper	elle
no'nt	VERcjg	nondre
eskoltet	NOMcom	écouté
les	DETdef	le
mals	ADJqua	mal
conselliers	NOMcom	conseillier
,	PONfbl	,
Qu'	CONsub	que
elle	PROper	elle
Deo	NOMpro	Dieu
raneiet	VERcjg	ranner
chi	ADVgen	ci
maent	VERcjg	marir
sus	ADVgen	sus
en	PRE	en
ciel	NOMcom	ciel
.	PONfrt	.

Ne	CONcoo	ne
por	PRE	por
or	NOMcom	or
ned	CONcoo	ne
argent	NOMcom	argent
ne	CONcoo	ne
paramenz	NOMcom	parement
,	PONfbl	,
Por	PRE	por
manatce	NOMcom	menace
regiel	NOMcom	regel
ne	CONcoo	ne
preiement	NOMcom	prément
,	PONfbl	,
Niule	NOMcom	neule
cose	NOMcom	chose
non	ADVneg	non
la	PROper	il
pouret	VERcjg	pourer
omque	ADVgen	omque
pleier	VERinf	plier
La	DETdef	le
polle	NOMcom	polle
sempre	ADVgen	sempres
non	ADVneg	non
amast	VERcjg	amer
lo	DETdef	le
Deo	NOMpro	Dieu
menestier	NOMcom	manestier
.	PONfrt	.

E	CONcoo	et
por	PRE	por
o	PROrel	où
fu	VERcjg	estre
presentede	VERppe	présenter
Maximiien	NOMpro	Malimien
Chi	PROrel	qui
rex	NOMcom	roi
eret	VERcjg	être
a	PRE	a
cels	DETdem	cil/celui
dis	NOMcom	di
soure	ADJqua	sûr
pagiens	NOMcom	pagien
.	PONfrt	.

Il	PROper	il
li	PROper	il
enortet	VERcjg	enorter
dont	PROrel	dont
lei	NOMcom	loi
nonque	ADVgen	nonque
chielt	VERcjg	choillir
Qued	CONsub	que
elle	PROper	elle
fuiet	VERcjg	fuir
lo	DETdef	le
nom	NOMcom	nom
christiien	ADJqua	chrétien
.	PONfrt	.

Ell'ent	VERcjg	ellier
adunet	VERppe	aduner
lo	DETdef	le
suon	ADJpos	son
element	NOMcom	élément
.	PONfrt	.

Melz	ADVgen	mieux
sostendreiet	VERcjg	sostendre
les	DETdef	le
empedementz	NOMcom	empédement
Qu'	CONsub	que
elle	PROper	elle
perdesse	VERcjg	perdre
sa	DETpos	son
virginitet	NOMcom	virginité
.	PONfrt	.

Por	PRE	por
os	NOMcom	os
furet	VERcjg	être
morte	VERppe	morir
a	PRE	a
grand	ADJqua	grand
honestet	NOMcom	honnêteté
.	PONfrt	.

Enz	ADVgen	ens
enl	PRE.DETdef	en
fou	NOMcom	feu
lo	PROper	le
getterent	VERcjg	jeter
com	CONsub	come
arde	VERcjg	ardre
tost	ADVgen	tost
.	PONfrt	.

Elle	PROper	elle
colpes	NOMcom	coupe
non	ADVneg	non
auret	VERcjg	avoir
,	PONfbl	,
por	PRE	por
o	PROrel	où
nos	PROper	nos
coist	VERcjg	coisir
.	PONfrt	.

A	PRE	a
czo	PROdem	ce
nos	PROper	nos
voldret	VERcjg	vouloir
concreidre	VERinf	concroire
li	DETdef	le
rex	NOMcom	roi
pagiens	NOMcom	pagien
.	PONfrt	.

Ad	PRE	à
une	DETndf	un
spede	NOMcom	épée
li	PROper	il
roveret	VERcjg	rover
tolir	VERinf	tolir
lo	DETdef	le
chief	NOMcom	chief
.	PONfrt	.

La	DETdef	le
domnizelle	NOMcom	domnicelle
celle	DETdem	cil
kose	NOMcom	chose
non	ADVneg	non
contredist	VERcjg	contredire
:	PONfbl	:
Volt	VERcjg	vouloir
lo	DETdef	le
seule	ADJqua	sol
lazsier	VERinf	lasser
si	ADVgen	si
ruovet	VERppe	rover
Krist	NOMpro	Christ
.	PONfrt	.

In	PRE	en
figure	NOMcom	figure
de	PRE	de
colomb	NOMcom	colomb
volat	VERcjg	voler
a	PRE	a
ciel	NOMcom	ciel
.	PONfrt	.

Tuit	PROind	tot
oram	VERcjg	orer
que	CONsub	que
per	PRE	par
nos	PROper	nos
degnet	VERcjg	dégner
preier	VERinf	priier
Qued	CONsub	que
auuisset	VERcjg	avoir
de	PRE	de
nos	PROper	nos
Christus	NOMpro	Christ
mercit	NOMcom	merci
Post	PRE	post
la	DETdef	le
mort	NOMcom	mort
et	CONcoo	et
a	PRE	a
lui	PROper	il
nos	PROper	nos
laist	VERcjg	laisser
venir	VERinf	venir
Par	PRE	par
souue	DETpos	son
clementia	NOMcom	clémentie
.	PONfrt	.

